wwwwwwwwwwww
wa.o....bb.w
w....bb....w
w...o......w
w.......bb.w
w..........w
w.bb....o..w
w.bb.......w
w.........bw
wo.......o.w
w....bb....w
wwwwwwwwwwww