wwwwwwwwwwww
w1...o.....w
w1......bb.w
w.......bb.w
w..o.......w
wb...b....bw
wb...b....bw
w....o..o..w
w.bb.......w
w.bb......2w
w....o....2w
wwwwwwwwwwww