wwwwwwwwwwww
wa...bb....w
w..o....bb.w
w.......bb.w
w...o......w
wb...b.o..bw
wb.o.b....bw
w....o.....w
w.bb....o..w
w.bb.......w
w....bb....w
wwwwwwwwwwww