wwwwwwwwwwww
wa.........w
w..bb......w
w..bb......w
w.....bb...w
w..........w
w..bb..bb..w
w..bb......w
w..........w
w.....bb...w
w..........w
wwwwwwwwwwww